1111111111111
1001000C000C1
1000P000C0C01
1000100E10001
1111111111111
