1111111111111
10010000000C1
100000PP00C01
1P00100E10001
1111111111011
